WWWWWWWWWWWWWWWWWWWWWWWWWWWWWWWWW
WWWWWWWWWWP           PWWWWWWWWWW
WP   P    PWWWWWWWWWWWP    P   PW
W WWW WWWWP  PWWWWWP  PWWWW WWW W
W WWWP  PWWWW WWWWW WWWWP  PWWW W
WP PWWWWP    P  J  P    PWWWWP PW
W WP    PWWWWWWW WWWWWWWP    PW W
W WWWWWW WWWWWWW WWWWWWW WWWWWW W
W WWWWWW WWWWW  I  WWWWW WWWWWW W
W WP    PWWWWWWWWWWWWWWWP    PW W
W W WWWWP               PWWWW W W
WP PWWWW WWWWWWWWWWWWWWW WWWWP PW
W WP    P PWP       PWP P    PW W
W WWWWWWWW W WWWWWWW W WWWWWWWW W
W WWWWWWWW W WP   PW W WWWWWWWW W
WP      P P PW WWW WP P P      PW
WWWWWWWW WWWP PWWWP PWWW WWWWWWWW
WWWWWWWW WWW WWWWWWW WWW WWWWWWWW
WWWP    P   P   P   P   P    PWWW
WWW WWWWWWWWWWWW WWWWWWWWWWWW WWW
WP P P          P          P P PW
W WWW WWWWWWWWWWWWWWWWWWWWW WWW W
WP   P                     P   PW
WWWWWWWWWWWWWWWWWWWWWWWWWWWWWWWWW